7
10
OXXXXXXXXX
OOOXOOOOXX
OXXXOXOXXX
OXOXOXOOOO
XXOXXXOXXX
XOOOOOOOXX
XXXXXXXOOOZ
