#################################
#   #           #       #       #
### # ####### # ### ##### ### # #
# # # #     # #     #     #   # #
# # # ##### # ##### # ##### # # #
#   #   #   # #           # #   #
# ##### # # # # ######### # ### #
#     #   # #   #     #   # #   #
##### ########### ### # ### # ###
#   #             #   # #   #   #
# # ######### ##### ##### ##### #
# #       #     #   #     #   # #
### # ##### ### # # # ####### # #
#   #       # #   #   #     # # #
# # # ####### ##### # # ### # # #
# # #     #   #   #   #   # #   #
# # ##### # ###   # # # ### # ###
#     #   #   #   # #   #   #   #
# ### # # ### ### # ##### #######
#   # # #     #   #     # #     #
# # # # ### # # # # ### # # ### #
# #   #   # # # # #     #     # #
### # ### # ### # # ########### #
#   # #   #     #   #     #   # #
# ### # ##### ####### ### # # # #
# #   # #   #   #   #   #   #   #
# ##### # # ##### # # # ####### #
# #     # #       # # #   #   # #
# # ##### ######### # ### # # # #
#   #     #   #   # #   #   # # #
# # # ##### ### # # ######### # #
#     #         #             # #
#################################
